8 8
11 9 1 2 9 3 9 3
12 6 10 10 14 12 6 10
9 1 6 8 5 5 3 10
10 12 7 10 9 5 4 6
10 9 1 6 12 5 5 3
14 10 12 3 9 3 13 2
9 6 11 10 14 12 5 2
12 5 6 12 3 13 5 6

16 16
0 0 0 0 0 0 0 0 0 0 0 0 0 0 0 0
0 1 0 0 0 1 0 0 0 0 0 0 0 1 0 0
0 1 0 1 0 0 0 0 0 1 0 0 0 0 0 0
0 0 1 0 1 0 0 1 0 0 1 0 0 0 1 0
0 0 0 1 0 0 0 0 1 0 0 0 0 0 0 0
0 0 0 0 0 1 1 0 0 0 0 1 0 0 0 0
0 1 1 0 0 2 0 0 1 0 0 0 0 1 1 0
0 0 0 0 1 0 0 1 0 0 0 1 0 0 0 0
1 0 0 0 0 1 0 0 0 0 0 0 0 0 0 0
0 0 0 0 1 0 1 0 1 0 0 1 0 0 0 0
0 0 0 0 0 0 1 0 0 0 1 0 0 0 0 0
0 0 0 0 1 0 0 0 1 0 0 0 0 1 0 0
0 0 0 0 2 1 0 1 0 0 0 1 0 0 0 0
1 0 0 0 1 0 0 1 0 0 2 0 1 0 0 0
0 0 0 0 0 0 1 0 0 0 0 0 0 0 0 0
0 0 1 0 0 0 0 0 0 0 0 0 0 1 0 0