10 10
9 5 5 5 4 5 3 9 1 7
10 9 3 13 5 3 10 10 12 3
10 10 12 5 5 2 10 10 9 6
12 6 9 5 3 10 10 10 12 3
9 3 10 11 12 2 8 6 11 10
10 10 10 12 5 6 12 5 10 10
10 8 4 7 9 1 5 3 10 10 
10 10 9 3 10 10 9 6 12 2
10 10 10 10 10 14 10 11 9 6
14 12 6 12 6 9 6 12 4 7 

20 20
0 0 1 0 0 0 0 0 0 0 0 0 0 1 0 1 0 0 0 0
0 0 0 0 0 1 0 0 0 0 1 0 0 0 1 0 0 0 0 2
0 1 1 0 0 0 2 0 0 0 0 0 0 0 8 8 1 0 0 0
0 0 0 0 0 0 0 0 0 1 0 0 0 1 8 8 0 0 1 0
0 0 0 0 1 0 8 8 8 8 0 0 0 0 8 8 0 0 0 0
0 0 0 0 1 0 8 8 8 8 0 0 0 0 8 8 1 0 0 0
0 0 1 0 4 4 4 4 4 4 1 0 0 0 8 8 0 0 0 0
1 0 0 0 4 4 4 4 4 4 0 0 1 0 8 8 0 0 1 0
1 0 0 1 0 0 0 1 0 0 0 0 0 0 1 0 0 1 0 0
0 0 1 0 0 0 0 0 0 0 0 0 0 0 0 0 0 0 0 0
8 8 0 0 0 0 0 0 0 1 0 0 0 0 0 0 0 0 0 0
8 8 0 0 1 0 1 0 0 0 0 0 1 0 1 0 0 0 0 0
8 8 0 0 0 0 1 0 12 12 12 12 0 0 0 0 0 0 0 0
8 8 0 0 1 0 0 0 12 12 12 12 0 0 0 0 0 1 0 0
8 8 0 0 0 0 0 0 1 0 0 0 1 0 0 0 0 0 0 0
8 9 0 0 0 1 0 0 0 0 0 0 0 0 0 0 1 0 0 1
8 8 0 0 0 0 1 0 0 0 0 0 0 0 1 0 0 0 0 0
8 8 0 0 0 1 0 0 0 1 0 0 0 0 0 0 0 1 0 0
0 0 4 4 4 4 4 4 4 4 0 0 0 0 0 0 0 0 1 0
1 2 4 4 4 4 4 4 4 4 0 0 1 0 0 0 0 0 0 0
