10 10
9 7 9 5 4 1 5 3 9 7
8 5 2 13 1 6 9 6 12 3
12 3 12 3 12 3 12 5 3 10
9 2 11 10 11 10 9 7 12 6
10 12 6 10 8 6 12 3 9 3
14 9 3 10 12 1 3 10 10 14
9 6 12 6 9 6 12 6 12 3
8 5 3 13 2 13 5 1 3 10
8 3 12 3 12 5 3 10 10 10
14 12 7 12 5 3 12 6 12 6

20 20
1 0 0 0 1 0 0 0 0 0 1 0 0 0 0 0 4 4 0 0 
0 0 0 1 0 0 0 1 0 0 0 0 0 0 0 1 4 4 0 2
0 0 0 0 0 0 0 0 0 1 0 0 5 4 4 4 4 4 8 8
0 1 0 0 0 0 1 0 0 0 0 0 4 4 4 4 4 4 9 8
0 0 0 0 0 0 0 0 0 0 0 1 0 0 0 1 0 0 8 9
0 0 0 0 0 0 0 0 0 0 1 0 0 1 0 0 0 0 8 8
0 0 0 0 0 0 8 8 1 0 0 0 0 0 0 0 0 0 8 8
1 0 0 1 0 0 8 8 0 0 0 1 0 0 0 0 1 0 8 8
0 0 0 0 0 0 8 8 4 4 0 0 0 0 0 0 0 0 0 0
0 0 0 0 0 0 9 8 4 4 0 0 0 1 0 0 0 0 0 0 
0 0 4 4 4 4 8 8 4 4 0 0 0 1 0 0 0 0 1 0
0 2 4 5 4 4 8 8 4 4 0 1 0 0 0 0 0 0 0 0
8 8 1 0 1 0 1 0 1 0 0 0 0 0 0 0 0 0 0 0  
8 8 0 1 1 0 0 1 0 0 0 1 0 1 0 0 0 1 0 0     
8 8 0 0 0 1 0 1 0 0 0 0 0 0 4 4 4 4 1 0      
8 9 0 0 0 0 2 0 0 1 0 0 0 0 4 4 4 4 0 0 
8 8 4 4 0 0 0 0 0 0 0 0 0 1 0 0 0 0 0 0 
8 8 4 4 1 0 0 0 1 0 0 1 0 0 0 1 0 0 0 0 
0 0 4 4 0 0 0 0 0 0 0 0 0 0 0 0 0 1 0 0 
1 0 4 4 0 0 0 0 0 0 0 0 1 0 0 0 0 0 0 0 