10 10
11 9 3 9 4 5 5 3 13 3
10 10 12 4 5 5 3 8 3 10
10 8 5 5 3 11 10 14 12 6
10 12 5 3 8 6 8 5 3 11
8 5 3 10 14 9 4 7 10 10
12 3 12 6 9 6 9 5 2 10
9 6 13 3 12 3 10 9 4 2
10 9 5 2 9 6 10 12 3 14
10 10 11 10 12 7 12 3 12 3
12 6 12 4 7 9 5 6 13 6

20 20
1 0 1 0 0 1 0 0 0 0 0 1 0 0 0 0 2 0 0 0
0 0 0 1 0 2 1 0 1 0 1 0 0 1 0 0 0 1 0 0
8 8 0 0 8 8 8 8 1 0 1 0 0 1 8 8 8 8 1 0
8 9 0 0 9 8 8 9 0 0 0 1 0 0 9 8 8 8 0 0
9 8 0 0 8 8 8 9 0 0 0 0 0 1 0 0 1 0 1 0
8 8 1 0 8 9 8 8 0 0 0 0 1 0 0 0 0 0 0 1
9 8 0 1 0 0 0 0 0 1 0 0 0 0 0 1 0 0 0 0
8 8 0 0 1 0 1 0 1 0 0 0 1 0 1 0 1 0 1 0
1 0 0 1 0 0 1 0 0 0 0 0 4 4 4 4 4 4 0 0
0 0 1 0 1 0 0 1 0 0 0 1 4 4 4 4 4 4 0 1
0 1 0 0 0 0 0 0 0 0 0 0 0 0 0 1 4 4 1 0
0 0 0 1 0 1 1 0 0 1 0 0 0 1 0 0 4 4 0 0
1 0 0 0 0 0 8 8 0 0 8 9 1 0 0 0 1 0 0 0
0 0 1 0 1 1 8 9 0 0 8 8 0 0 0 0 0 0 0 0
0 1 4 4 0 0 8 8 0 0 8 8 0 0 8 8 8 9 1 0
1 0 4 4 1 0 9 8 0 0 9 8 0 0 8 8 9 8 0 0
0 0 4 4 1 0 8 9 0 0 0 0 0 1 0 0 0 0 0 0
0 1 4 4 0 0 9 8 0 0 1 0 1 0 0 0 1 1 0 0
0 0 1 0 0 1 0 0 2 0 0 0 0 0 1 0 0 0 0 0
0 0 0 0 0 0 0 0 0 0 0 0 1 0 0 0 0 1 0 0