10 10
11 9 3 9 2 9 7 9 3 11
8 6 12 2 10 12 5 6 8 6
12 5 7 10 8 1 5 7 12 3
9 3 9 2 10 8 5 3 9 2
14 10 10 14 12 5 3 10 14 10
9 4 6 9 5 3 10 12 1 6
10 9 5 6 11 10 10 11 12 3
10 12 3 11 10 10 10 10 9 6
8 7 12 4 2 10 10 10 10 11
12 5 5 5 6 10 12 6 12 6

20 20
1 0 0 0 0 0 0 1 0 0 1 0 0 0 1 0 0 0 0 0
0 0 0 0 0 1 0 0 0 1 0 1 0 0 0 0 1 0 0 0
8 8 8 8 0 0 4 4 0 0 9 8 8 8 8 8 0 1 1 0
8 8 8 8 0 0 4 4 1 0 8 8 8 9 8 8 1 0 0 0
0 0 0 0 0 0 4 4 4 4 4 4 0 0 0 0 0 1 8 8
0 0 0 1 0 0 4 4 4 4 4 4 1 0 0 0 0 0 9 8
1 0 0 0 1 0 4 4 1 0 1 0 0 0 0 1 0 0 8 8
0 0 0 0 0 1 4 4 0 0 0 0 0 1 0 0 0 0 8 8
0 1 0 0 0 0 1 0 9 8 8 8 8 9 0 0 0 0 8 9
0 0 0 0 0 0 0 0 8 8 9 8 8 8 0 0 0 0 9 8
1 0 8 8 8 9 0 0 0 0 0 0 0 0 0 1 0 0 0 0
0 0 9 8 8 8 0 1 0 0 0 1 0 0 0 0 0 1 0 0
9 8 0 0 0 1 0 0 0 1 1 0 0 1 1 0 0 0 0 0
8 8 0 1 0 0 0 0 0 0 1 0 0 0 0 0 0 0 1 0
9 8 0 0 0 0 0 0 0 0 0 1 0 0 9 8 0 0 0 0
8 9 1 0 0 0 1 0 1 0 0 0 0 0 8 9 0 1 0 0
0 0 0 0 0 0 0 0 0 0 1 0 0 0 8 8 0 0 0 0
0 0 0 0 0 0 0 0 0 0 0 1 0 0 8 9 0 0 0 0
0 0 0 1 0 0 0 0 0 0 0 0 4 4 4 4 0 0 0 0
1 0 0 0 0 0 1 1 0 0 0 0 4 4 4 4 1 1 0 0